NO ./texture/wall_n.xpm SO ./texture/asdasd.xpm
WE ./texture/c.xpm 
EA ./texture/a.xpm

F 154,155,123 
C 155,123,102

1111
10N1
1111
