NO ./texture/wall_n.xpm SO ./texture/asdasd.xpm
WE ./texture/c.xpm 
EA ./texture/a.xpm

C 154,155,123 
F 0,0,0

111111111111111111111111111111111111111111
111111111111111111111111111111111111111111
111111111111111111111111111111111111111111
100000000000111000000000000000000000000001
100000000000111000000000000000000000000001
100000000000111000000000000000000000000001
101100000000111111000000000000000000000001
101100000000111111000000000000000000000001
101100000000111111000000000000000000000001
100100000000000000000000000000000000000001
100100000000000000000000000000000000000001
100100000000000000000000000000000000000001111111111111111111111111111
111111111111011000000000111000000111000000000000000000000000000000001
111111111111011000000000111000000111000000000000000000000000000000001
111111111111011000000000111000000111000000000000000000000000000000001
100000000000011000000000111000000111011111111111111111111111111111111
100000000000011000000000111000000111011111111111111111111111111111111
100000000000011000000000111000000111011111111111111111111111111111111
111101111111111111111111111011100000000000000000100000000100000000001
111101111111111111111111111011100000000000000000100000000100000000001
111101111111111111111111111011100000000000000000100000000100000000001
111101111111111111111111111011101010100000000000000000000100000000001
111101111111111111111111111011101010100000010000100000000100000000001
11110111111111111111111111101110101010000000000010000000010000N000001
110000000000000000110101011101110000000000000000100000000100000000001
110000000000000000110101011101110000000000000000100000000100000000001
110000000000000000110101011101110000000000000000100000000000000000001
100000000000000000000000000000011000000000000000100000000100000000001
100000000000000000000000000000011000000000000000100000000100000000001
100000000000000000000000000000011000000000000000100000000100000000001
100000000000000000001000000000011011010100100000100000000100000000001
100000000000000000001000000000011011010100100000100000000100000000001
100000000000000000001000000000011011010100100000100000000100000000001
110000000000011100001111111011111111011111011111011111011111011111011
110000000000011100001111111011111111011111011111011111011111011111011
110000000000011100001111111011111111011111011111011111011111011111011
111101111111111111111111010101101011110100000000001000000000100000001
111101111111111111111111010101101011110100000000001000000000100000001
111101111111111111111111010101101011110100000000001000000000100000001
111111111111111111111111111111111111111111111111111111111111111111111
111111111111111111111111111111111111111111111111111111111111111111111
111111111111111111111111111111111111111111111111111111111111111111111
