NO ./texture/wall_n.xpm
SO ./texture/asdasd.xpm
WE ./texture/c.xpm
EA ./texture/a.xpm

F 0,120,50
C 0,120,50



1111111
1000001
10000N1
1111111