NO ./texture/wall_n.xpm SO ./texture/asdasd.xpm
WE ./texture/c.xpm 
EA ./texture/a.xpm

F 154,155,123 
C 155,123,102

111111111
100000001
100000001
100000001
100000001
100000001
100000001
100000001
1000N0001
111111111
