NO ./texture/wall_n.xpm
SO ./texture/asdasd.xpm
WE ./texture/c.xpm
EA ./texture/a.xpm

F 0,120,50
C 0,110,50

 11111
 10S1 
11111 

