NO ./texture/n.xpm f
SO ./texture/s.xp
WE ./texture/w.xpm 
DF

C 154,-155,343046456
F 0,0,,0,5
	
	11111111111111111111111111     
    100000000011000000000000  	                     11
	10110000011100000S000000                
	10010000000000000N0000001
111111111011000001110000000000001
100000000011000001110111111111111 
11110111111111011100000010001
11110111111111011101010010001 
11000000110101011100000010001  
10000000000000001100000010001              
100000001W0000001101010010001  
1100000111000111111101111000111
11110111 1110101 101111010001
11111111 1111111 11111111111

11

