NO	./texture/n.xpm SO ./texture/s.xpm
WE ./texture/w.xpm 
EA ./texture/e.xpm

C 154,155,0
F 0,0,0 

        11111111111111111111111111     
        1000000000110000000000001                        
        1011000001110000000000001                
        1001000000000000000000001
111111111011000001110000000000001
100000000011000001110111111111111 
11110111111111011100000010001
11110111111111011101010010001 
11000000110101011100000010001  
10000000000000001100000010001
100000001W0000001101010010001
1100000111000111111101111000111
11110111 1110101 101111010001
11111111 1111111 111111111111

